1,  1,        104;
2,  1,2,      104,103;  
3,  1,2,3,    104,103,102;
4,  2,3,4,    103,102,101;
5,  3,4,5,    102,101,100;
6,  4,5,6,    101,100,99;
7,  5,6,7,    100,99,98;
8,  6,7,8,    99,98,97;
9,  7,8,9,    98,97,96;
10, 8,9,10,   97,96,95;
